001111111100
011111111110
011111111110
111112211111
111122221111
111223322111
111223322111
111223322111
111223322111
111122221111
111112211111
011111111110
001111111100
001111111100
150