011111111111111110
011111222222111110
011112222222211110
011112222222211110
011122222222221110
011122223322221110
111222233332222111
111222333333222111
112222333333222211
112222333333222211
112222333333222211
011222233332222110
011122223322221110
011112222222211110
001111222222111100
001111222222111100
001111111111111100
000111111111111000
000111111111111000
300